BBBBBBBBBBBBBBBBBBBBBBBBBBBBBBBBBBBBBBBB
BP       P        PBP        P       PBB
B BBBBBBB BBBBBBBB B BBBBBBBB BBBBBBB BB
B BBBBBBB BBBBBBBB B BBBBBBBB BBBBBBB BB
B BBBBBBB BBBBBBBB B BBBBBBBB BBBBBBB BB
B BBBBBBB BBBBBBBB B BBBBBBBB BBBBBBB BB
BP       P     P  P P  P     P       PBB
B BBBBBBB BBBBB BBBBBBB BBBBB BBBBBBB BB
B BBBBBBB BBBBB BBBBBBB BBBBB BBBBBBB BB
BP  PBBBBP  PBBP  PBP  PBBP  PBBBBP  PBB
B BBP    PBB BBBBB B BBBBBPBBP    PBB BB
B B BBBBB BB BBBBB B BBBBB BB BBBBBBB BB
B BBP    P  PBBBBB B BBBBBP  P    PBB BB
BP  PBBBB BBP  P  PPP  P  PBB BBBBP  PBB
BBBBBBBBB BB BB BBB BBB BB BB BBBBBBBBBB
BBBBBBBBBP  PBB B  P  B BBP  PBBBBBBBBBB
BBBBBBBBBBBB BB B  P  B BB BBBBBBBBBBBBB
BBBBBBBBBBBB BB B  P  B BB BBBBBBBBBBBBB
BBBBBBBBBBBB BB BBB BBB BB BBBBBBBBBBBBB
BBBBBBBBBBBBP  P   P   P  PBBBBBBBBBBBBB
BBBBBBBBBBBB BB BBBBBBB BB BBBBBBBBBBBBB
BBBBBBBBBBBB BB BBBBBBB BB BBBBBBBBBBBBB
BBBBBBBBBBBB BBP   P   PBB BBBBBBBBBBBBB
BBBBBBBBBBBB BB BBB BBB BB BBBBBBBBBBBBB
BBBBBBBBBBBB BB BBB BBB BB BBBBBBBBBBBBB
BP       P  P  P   P   P  P  P       PBB
B BBBBBBB BB BBBBBBBBBBBBB BB BBBBBBB BB
B BBBBBBB BB BBBBBBBBBBBBB BB BBBBBBB BB
BP    PBB BBP    PBBBP    PBB BBP    PBB
BBBBBB BB BB BBBB BBB BBBB BB BB BBBBBBB
BBBBBB BB BB BBBB BBB BBBB BB BB BBBBBBB
BP    PBB BB BBBB BBB BBBB BB BBP    PBB
B BBBB BB BBP    P   P    PBB BB BBBB BB
B BBBB BBP  PBBBBBBBBBBBBBP  PBB BBBB BB
B BBBB BBBBB BBBBBBBBBBBBB BBBBB BBBB BB
B BBBBP     P    PBBBP    P     PBBBB BB
B BBBB BBBBBBBBBB BBB BBBBBBBBBB BBBB BB
B BBBB BBBBBBBBBB BBB BBBBBBBBBB BBBB BB
BP    P          P   P          P    PBB
BBBBBBBBBBBBBBBBBBBBBBBBBBBBBBBBBBBBBBBB
