BBBBBBBBBBBBBBBBBBBBBBBBBBBBBBBBBBBBBBBB
BP       P        PBP        P       PBB
B BBBBBBB BBBBBBBB B BBBBBBBB BBBBBBB BB
B B     B B      B B B      B B     B BB
B B     B B      B B B      B B     B BB
B BBBBBBB BBBBBBBB B BBBBBBBB BBBBBBB BB
BP       P     P  P P  P     P       PBB
B BBBBBBB BBBBB BBBBBBB BBBBB BBBBBBB BB
B BBBBBBB BBBBB BBBBBBB BBBBB BBBBBBB BB
BP  PBBBBP  PBBP  PBP  PBBP  PBBBBP  PBB
B BBP    PBB BBBBB B BBBBBPBBP    PBB BB
B B BBBBB BB BBBBB B BBBBB BB BBBBBBB BB
B BBP    P  PBBBBB B BBBBBP  P    PBB BB
BP  PBBBB BBP  P  PPP  P  PBB BBBBP  PBB
BBBBBB  B BB BB BBB BBB BB BB B  BBBBBBB
B       BP  PBB B  P  B BBP  PB        B
B       BBBB BB B  P  B BB BBBB        B
B          B BB B  P  B BB B           B
B          B BB BBB BBB BB B           B
B          BP  P   P   P  PB           B
B          B BB BBBBBBB BB B           B
B          B BB BBBBBBB BB B           B
B          B BBP   P   PBB B           B
B          B BB BBB BBB BB B           B
BBBBBBBBBBBB BB BBB BBB BB BBBBBBBBBBBBB
BP       P  P  P   P   P  P  P       PBB
B BBBBBBB BB BBBBBBBBBBBBB BB BBBBBBB BB
B BBBBBBB BB BBBBBBBBBBBBB BB BBBBBBB BB
BP    PBB BBP    PBBBP    PBB BBP    PBB
BBBBBB BB BB BBBB BBB BBBB BB BB BBBBBBB
BBBBBB BB BB BBBB BBB BBBB BB BB BBBBBBB
BP    PBB BB BBBB BBB BBBB BB BBP    PBB
B BBBB BB BBP    P   P    PBB BB BBBB BB
B BBBB BBP  PBBBBBBBBBBBBBP  PBB BBBB BB
B BBBB BBBBB BBBBBBBBBBBBB BBBBB BBBB BB
B BBBBP     P    PBBBP    P     PBBBB BB
B BBBB BBBBBBBBBB BBB BBBBBBBBBB BBBB BB
B BBBB BBBBBBBBBB BBB BBBBBBBBBB BBBB BB
BP    P          P   P          P    PBB
BBBBBBBBBBBBBBBBBBBBBBBBBBBBBBBBBBBBBBBB
